00000000000000000000000000000
00000001111100000000000000000
00001111111100000000111000000
01111111011100011111111111100
11111110101000111111111111111
00111111100001111111111111000
00011111100001111111111110000
00011111000001001111111110100
00011110000011111111111110100
00001100000011111111111100000
00000111000011111100101000000
00000011110001111100001100000
00000011111000111000000111100
00000001111000111000000000000
00000001110000011010000011000
00000001100000010000000111101
00000001100000000000000111101
00000001000000000000000000000
